*.................GGGGGGGGGGGGGGGGGGGGGGGGGGGGGGGGGGGGGGGGGGGGGGGGGGGGGGGGGGGGGGGGGGGGGGGGGGGGGGGGGGGGGGGGGGGGGGGGGGGGGGGGG**************
*.................GGGGGGGGGGGGGGGGGGGGGGGGGGGGGGGGGGGGGGGGGGGGGGGGGGGGGGGGGGGGGGGGGGGGGGGGGGGGGGGGGGGGGGGGGGGGGGGGGGGGGGGGG**************
*.................GGGGGGGGGGGGGGGGGGGGGGGGGGGGGGGGGGGGGGGGGGGGGGGGGGGGGGGGGGGGGGGGGGGGGGGGGGGGGGGGGGGGGGGGGGGGGGGGGGGGGGGGG**************
*.................GGGGGGGGGGGGGGGGGGGGGGGGGGGGGGGGGGGGGGGGGGGGGGGGGGGGGGGGGGGGGGGGGGGGGGGGGGGGGGGGGGGGGGGGGGGGGGGGGGGGGGGGG**************
*.................GGGGGGGnnGGGGGGGnnGGGddddddGGtttttttttGGGGGeGGGGGGnGGGGGGGGGGGGdddddGGtGGeGGGeGGnnnnnGGdGGGGGGGGGGGGGGGGG**************
*.................GGGGGGGnGnGGGGGnGnGGGdGGGGGGGGGGGtGGGGGGGGeGeGGGGGnGGGGGGGGGGGGdGGGdGGtGGGeGeGGGnGGGGGGdGGGGGGGGGGGGGGGGG**************
*.................GGGGGGGnGGnGGGnGGnGGGddddGGGGGGGGtGGGGGGGeeeeeGGGGnGGGGGGGGGGGGdddddGGtGGGGeGGGGnnnGGGGdGGGGGGGGGGGGGGGGG**************
*.................GGGGGGGnGGGnGnGGGnGGGdGGGGGGGGGGGtGGGGGGeGGGGGeGGGnGGGGGGGGGGGGdGGGGGGtGGGeGeGGGnGGGGGGdGGGGGGGGGGGGGGGGG**************
*.................GGGGGGGnGGGGnGGGGnGGGddddddGGGGGGtGGGGGeGGGGGGGeGGnnnnnGGGGGGGGdGGGGGGtGGeGGGeGGnnnnnGGdddddGGGGGGGGGGGGG**************
*.................GGGGGGGGGGGGGGGGGGGGGGGGGGGGGGGGGGGGGGGGGGGGGGGGGGGGGGGGGGGGGGGGGGGGGGGGGGGGGGGGGGGGGGGGGGGGGGGGGGGGGGGGG**************
*.................GGGGGGGGGGGGGGGGGGGGGGGGGGGGGGGGGGGGGGGGGGGGGGGGGGGGGGGGGGGGGGGGGGGGGGGGGGGGGGGGGGGGGGGGGGGGGGGGGGGGGGGG..*************
*.........P.......GGGGGGGGGGGGGGGGGGGGGGGGGGGGGGGGGGGGGGGGGGGGGGGGGGGGGGGGGGGGGGGGGGGGGGGGGGGGGGGGGGGGGGGGGGGGGGGGGGGGGGG#...************
*****************************************************************************************************************************************
*****************************************************************************************************************************************